4. August: 
Internationaler Ehrentag der Eule 	(kein Jahr)


[SchÃ¼lerwohnort ðŸ«][Â± [___en: Rechenoperation]chen][G[S___ : NÃ¤hmaschine; Bandmitglied; Index fÃ¼r neurologisch Behandlung] ___]r [Gewâ†’___â†[unebener Weg mit tiefen ___en]t][["Alt wie ein ___"] in [___bÃ¤rt wird vermisst]r der [Das ðŸ’¦ herausbekommen durch ausw___en]e][[___mel = fragwÃ¼rdig-viel[was Sigmund Freud unabsichtlich tut]der Abwehrjog["ðŸ‘¶ dont ___ me no more"]][was [Spitz[vor kurzen im Mathebau getrennt]er]trophoben fÃ¼rchten]sell[f[___en: anderen zuhÃ¶ren; bespitzeln]iges Tier, jeder schert sich drum doch nur manche wollen es]t Abk.] der [___r: [Aurum][ðŸ‡©ðŸ‡ª be[zeigen; analysieren]dster Musiker]s be[weisen; begreifen]dster [frÃ¼her durch [[beste W[Z___: Nadelbaum aus den Alpen ðŸŒ², bekannt fÃ¼r MÃ¶bel, angebliche HeilkrÃ¤fte oder Schnaps]l[Ob Echsenmenschen da dazuzÃ¤hlen? (Plural)]; Nachname (Plural)] des Jahres 2020, nicht verliebt] verbundene Korrespondenten; entfernte aber enge Bekannte; (Singular)]]




Internat: SchÃ¼lerwohnort ðŸ«
ion: Â± Teilchen
	Teil: ___en: Rechenoperation
ale: Ginger ___
	inger: S___ : NÃ¤hmaschine; Bandmitglied; Index fÃ¼r neurologisch Behandlung
Ehr: Gew -> ___ <- furcht 
	furch: unebener Weg mit tiefen ___en
ent: Baum in Herr der Ringe
	Baum: "Alt wie ein ___"
	Her: ___bÃ¤rt wird vermisst 
	Ring: Das ðŸ’¦ herausbekommen durch ausw___en 
ag: Aktiengesellschaft Abk.
	Akti: ___mel = fragwÃ¼rdig-vielversprechender Abwehrjoghurt
		versprechen: was Sigmund Freud unabsichtlich tut
		hurt: "ðŸ‘¶ dont ___ me no more"
	enge: was Klaustrophoben fÃ¼rchten
		Klaus: SpitzmÃ¼ller
			MÃ¼ll: vor kurzen im Mathebau getrennt
	schaf: flauschiges Tier, jeder schert sich drum doch nur manche wollen es
		lausch: ___en: anderen zuhÃ¶ren; bespitzeln
Eule: ___r: Goldbachs bedeutendster Brieffreund
	Gold: Aurum
	Bach: ðŸ‡©ðŸ‡ª bedeutendster Musiker
		deuten: zeigen; analysieren 
	deuten: weisen; begreifen
	Brieffreunde: frÃ¼her durch Tauben verbundene Korrespondenten; entfernte aber enge Bekannte; (Singular)
		Tauben: VÃ¶gel des Jahres 2020, nicht verliebt
			VÃ¶gel: beste Wirbeltiere; Nachname (Plural)
				irbe: Z___: Nadelbaum aus den Alpen ðŸŒ², bekannt fÃ¼r MÃ¶bel, HeilkrÃ¤fte oder Schnaps
				Tiere: Ob Echsenmenschen da dazuzÃ¤hlen?	



-----------------------------------------------------------------------------------------------------------------------------------------------------------------------------------


1. August
Ã„gypten erklÃ¤rt Elon Musk, dass Pyramiden nicht von Aliens gebaut wurden. (2020)

[Land am [___s: GÃ¤nseflieger]] erklÃ¤rt [[Die Bootgang, Hellapagos oder Hanabi][Zutat fÃ¼r ["___ die mag ich sehr, sie schmecken mir am besten"] die durch auspressen mit Handtuch und trocknen lassen gewonnen wird]]n [[D-___; Grenzgebiet; Zuckerberg] mit Zucker (ðŸŽ)]k, dass [___o: ist doch kein Ver[Ã¼bergeben; trennen; fraktionieren] (De[lÃ¤ngster Fluss in ðŸ‡®ðŸ‡³]tri[form___: prÃ¤zise beschrieben])][Acryl___: Entsteht beim zu heiÃŸen f[MÃ¶nchhausen auf Kanonenkugel]ieren von [ErdÃ¤pfel (Plural)]]en nicht von [[Prophet im Islam] ðŸ¥Š]ens gebaut wurden.

Ã„gypten: Land am Nil
	Nil: ___s: GÃ¤nseflieger
Elo: SpielstÃ¤rke
	Spiel: Die Bootgang, Hellapagos oder Hanabi
	StÃ¤rke: Zutat fÃ¼r thÃ¼ringer KlÃ¶ÃŸe die durch auspressen mit Handtuch und trocknen lassen gewonnen wird
		thÃ¼ringer KlÃ¶ÃŸe: "___ die hab mag ich sehr, sie schmecken mir am besten"
Mus: ðŸŽ Mark mit Zucker
	Mark: Zuckerberg
Pyr: ___o: ist doch kein Verbrechen (Deindustrialisiert)
	brechen: Ã¼bergeben; trennen; fraktionieren
	indus: lÃ¤ngster Fluss in ðŸ‡®ðŸ‡³
	alisiert: form___: prÃ¤ziese beschrieben
Amid: Acryl___: Entsteht beim zu heiÃŸen frittieren von Kartoffeln
	ritt: MÃ¶nchhausen auf Kanonenkugel 
	Kartoffeln: ErdÃ¤pfel (Plural)
Ali: Muhammand ðŸ¥Š
	Muhammad: Prophet im Islam

